15.ox
.......oo................ooo..
..o..o....o.o....o.o....o.....
.o...o...o.o.o..........o.....
.......o..o.ooo.......o.o.o...
.....o.o...o........o..o.o....
o............o....o.o.o..o....
..o.....o....o...o...o......o.
....o...............o.....o...
.....o..o....o..oo........o...
........o........o.....o.oo.o.
.o.oooo.oo....oo.oo......oo...
...o....o..o.......o.....o...o
.....o.......o..............o.
.o.o..o........o.......o....oo
.......o.o..o..........o....o.
