15.ox
.oo....ooo..o.....o...o....o.o
o....oo.o...........o....oo...
.o.oo..........oo....o......oo
.o..o...o......o.o...o..o.o...
....oo....o..oo........o.....o
.............o..o.....o.oo.ooo
....o....o.o..oo..o....o..o.o.
......oo.o...o...o...o...o....
oo..o..oo...o..o.....o........
...oooooooo.oo.....oo.....o...
...oo.o....o....o.oo......o..o
...o.o..o...oo.oo.o....o......
oooo...oo..o.o.o...o......o.o.
o...........o.....oooo..o.....
oo..o....o..........o..oo.oo.o
