15.ox
.oo...oo.....o.....o..........
.o........o.o...o.o.......o..o
...oo.o....o...o..oo.oooo...o.
............oo........o...o...
.o.o..o............oo.o.o.....
ooo.o...o.......o.o.o.ooo.o...
o...o.....oo............o.o...
.oo..........o.o.....o........
..ooo...............o...o.....
......o.................o..o..
..o.....o...........ooo....o..
..o....o..o..........o......o.
.o.....o....oo..oo.o..........
.................o..o...o.....
..o..o....o...................
