15.ox
o......o.o....o..o.oo...oo.oo.
...o.oo.o...o..o.....o....oo.o
o.o..o.o.o........o.....oo.oo.
o....o..o.oo.o.....o.o........
o.o........o..o..oo.o.o.o.....
o.......ooo.....o..o.oo....oo.
..o.o.ooo..o....o..o....o.....
o......oo.ooooo.....oo.oo.ooo.
....o.oo..oo...o....oooo..o..o
o...o.......oo..o.............
.o.....o.oooo..o.ooo.....o..o.
o.oo.....oo....o.......o.oo...
.......o.ooo....o.....oooo.o.o
.....oo..oo...o..oo...o....ooo
.o....o..o.....o..oo...o..o...
